.#....#.###.........#..##.###.#.....##...
...........##.......#.#...#...#..#....#..
...#....##..##.......#..........###..#...
....#....####......#..#.#........#.......
...............##..#....#...##..#...#..#.
..#....#....#..#.....#.#......#..#...#...
.....#.#....#.#...##.........#...#.......
#...##.#.#...#.......#....#........#.....
....##........#....#..........#.......#..
..##..........##.....#....#.........#....
...#..##......#..#.#.#...#...............
..#.##.........#...#.#.....#........#....
#.#.#.#......#.#...##...#.........##....#
.#....#..#.....#.#......##.##...#.......#
..#..##.....#..#.........#...##.....#..#.
##.#...#.#.#.#.#.#.........#..#...#.##...
.#.....#......##..#.#..#....#....#####...
........#...##...#.....#.......#....#.#.#
#......#..#..#.#.#....##..#......###.....
............#..#.#.#....#.....##..#......
...#.#.....#..#.......#..#.#............#
.#.#.....#..##.....#..#..............#...
.#.#....##.....#......##..#...#......#...
.......#..........#.###....#.#...##.#....
.....##.#..#.....#.#.#......#...##..#.#..
.#....#...#.#.#.......##.#.........#.#...
##.........#............#.#......#....#..
.#......#.............#.#......#.........
.......#...##........#...##......#....#..
#..#.....#.#...##.#.#......##...#.#..#...
#....##...#.#........#..........##.......
..#.#.....#.....###.#..#.........#......#
......##.#...#.#..#..#.##..............#.
.......##.#..#.#.............#..#.#......
...#....##.##..#..#..#.....#...##.#......
#....#..#.#....#...###...#.#.......#.....
.#..#...#......##.#..#..#........#....#..
..#.##.#...#......###.....#.#........##..
#.##.###.........#...##.....#..#....#.#..
..........#...#..##..#..##....#.........#
..#..#....###..........##..#...#...#..#..